0 7 6 3 2 0
9 8 5 4 1 x
0 4 4 4 0 0
0 4 0 4 0 0
0 4 4 4 0 0
