1 1 1 3 4
1 0 1 3 5
1 x 1 3 3
1 0 1 1 3
1 1 1 2 2
