0 0 0 0 x 0
1 1 1 1 1 0
1 1 1 1 8 9
1 1 0 0 0 0
1 1 1 1 1 0
1 1 1 1 1 0
