4 4 4 4 4
4 2 2 2 4
4 2 x 4 4
4 2 2 4 4
4 4 4 6 8
